About = Avaut
Access = Axes
Actually = Actauly
Adds = Ets
Agree = Agrii
ahjs = ASj kl kl
Aight = Ayt
Air = R
All = Ol
Allow = Elluw
Always = Alwes
Amazing = Amensin
An = Am
And = A
And = Ann
Anyone = Animon
API = API
App = Ab
Application = Ablikatjen
Are = Aiggt
Are = Re
Arepa = Agepa
At = Att
Atention = Attontin; Attontjen
Automatically = Otumattiklly
Awaits = Aiwets
Bad = Baf
Bamboo = Bembu
Be = Bi
Before = Bifure
Begin = Vewin
Better = Bater
Bit = Bitt
Blind = Blund
Both = Bof
Bruh = Burv
Btw = Ptv
Bug = Bux
Building = Byldin
But = Bat
By = Pie
Call = Coll
Can = Cun
Careful = Cerefool
Channel = Ckanul
Cities = Citis
City = Citi
Civilization = Civylsatjen
Collaborator = Culloboretor
Coments = Coomats
Company = Campaie
Compare = Cumpair
Complex = Conplsx
Comunication = Conuunixatjen
Confusing = Konfjusin
Consistent = Konzistant
Correct = Corex
Course = Clurse
Create = Criate
Creator = Critor
Currently = Curenlyd
Dang = Dong
Day = Dai
Days = Taiess
Defeat = Difit
Delete = Diliyt; Dilit
Descrption = Deskryptn
Development = Deflupmat
Dialects = Daialekts
Dictionary = Dicchionarri
Did = Tat
Diferent = Difren
Different = Diifrenp
Discord = Dascurt
Do = Du
Does = Dos
Doing = Duin
Don't = Dunt
Done = Dann
Download = Dawgloud
Easy = Isi
Elytra = Aliutra
Empire = Ennprye
English = Anglysh
Ever = Evre
Everything = Evrityn
Evil = Iibil
Expand = Ekspant
Explain = Eksploin
Famous = Faamus
Farm = Fudcritor
Fast = Fasst
Fault = Feult
Feature = Fitsere
File = Fyle
Fix = Fik
Foes = Fous
Food = Fud
For = Fur
Forever = Furevre
Forgot = Foggut
Form = Fomm
Formulate = Formukat
Found = Faund
Free = Fry
From = Frum
Fuck = Dufk
Full = Fooll
Game = Grannar
Gandalf = Gnadalf
Genialer = Kenjaler
Get = Gat, Geme
GitHub = Yeethab
Go = Gud
God = Halp
Good = Haf
Gosh = Gassh
Got = Gou
Grammar = Guud
Guess = Gass
Guy = Gai
Had = Hun
Have = Hare
Have = Hu
Have = Hud
Have = Ice
He = Hu
Hell = Hoff
Hello = Hov
Help = Heil
Help = Huv
Here = Hilu
Him = Huv
How = see I
Humble = Jumvle
I = Ai
Idea = Eidd
If = Iff
iirc = iark
Implement = Inblemmat
In = Inn
Iniciated = Inetjated
Interesting = Interestun
Internet = Entrnoot
Into = Inntu
Invent = Envant
Invention = Envantjen
Is = Itt
It = Id
Join = Yuim
Just = Chast
Just = Juist
Keep = Kiib
Kill = Kul
Labour = Laborwk
Language = Lagguage
Laugh = Logkt
Learn = Lirn
Let = Lit
Lie = Lay
Lieing = Layin
Like = Leik
List = Liyst
Live = Lif
Loan = Liin
Long = Lonw
Look = Luke
Make = Meik
Matter = Mettr
Maybe = Nejbii
Mean = Miin
Means = Moans
Migh = My
Mistake = Mitaxe
Misunderstand = Musunersdant
Misunderstood = Musunerstutt
Mixture = Misctsur
Mobile = Mubil
Mod = Muud
Morning = Murnin
Most = Moost
Move = Moof
Multiplayer = Muletepliyr
Music = Mjusicc
My = Mai
My = Min
Need = Nait
Need = Niid
Neither = Nider
Network = Nootlaborwk
New = Ny
Nice = Nais
Night = Nigk
No = Nii
Notifications = Nootifikatjens
Of = Oof
Off = Uf
Often = Uftan
Oh = O
On = Onn
One = Von
Online = Oline
Open = Opn
Opensource = Opnsurse
Other = Oder
Our = Awr
Overlook = Uwerlouk
People = Pible; Pipol
Permission = Pearmxjen
Player = Pliyr
Problem = Brolem
Proof = Pruff
Propose = Puroce
Question = Kvastun
Really = Raly
Reimplementation = Riymplemetnatjen
Remember = Rimenner
Reminder = Rimenner
Remove = Rimoof
Replicate = Replikat
Request = Riqwest
Requests = Riqweests
Required = Riqwaired
Research = Risourch
Right = Reigt
Right = Reit
Said = Sait
Same = Samme
Seams = Sims
See = Ce
Sent = Seent
She = Shu
Should = Chuld; Sould
Should = Sould
Sleep = Slipp
Small = Smol
Smart = Smarf
So = Su
Someone = Sumron
Sorry = Sowy
Source = Surse
Stand = Santd
Standarize = Sdandarrdise
Stick = Stik
Stupid = Stoopet
Sure = Chorre
Swing = Sfing
Symbol = Simbel
Taken = Teycen
Talk = Takk
Technologies = Texnologeese
Test = Tiest
Thanks = Fangks
That = Tgat
The = Teh
Things = Tinks
This = Diz; Tiss; Tiz; Thid
Time = Tyme
To = Tu
Todo = Tudu
Tomorrow = Tamoruv
Tomorrow = Yumurrow
Too = Tuu
Translate = Tronshlake
Turn = Torn
Turns = Tuons
Tutorial = Tuutroriel
UnCiv = uncOv
Understand = Unersdant
Unhappiness = Upinejens
Unit = Uuniyt
Upload = Aploud
Us = Uus
Use = Uz
Used = Uzet
User = Uuser
User = Uzar
Verb = Voeb
Very = Veru
Wait = Weit
Want = Wuntr
Want = Wuntr
Was = Wuss
Way = Vai
We = Wii
Weird = Wyrt
What = Wass
What = Wut
Where = Vare
Who = Hulf
Will = Vil
Wish = Wush
With = Wif
Wonder = Wuntr
Word = Wodd
Work = Laborwk
Worker = Slawork
World = Wuwld
XD = ksD
Yeah = Yih
You = Yo
You = Yu
Your = Yore
Your = Yur
